111111111
122222021
122200201
122222221
1222p2221
122202221
102202221
102222221
111111111
