111111111
100000021
102000201
100000001
1000p0001
100000221
100000021
100002001
111111111
