111111111
100002001
100020001
122000021
1200p0001
122200201
100002221
120020201
111111111
