111111111
100000001
100000001
100020001
1000p0001
100202001
100000001
100000001
111111111
