111111111
120000001
100000001
100000001
1000p0201
100000001
102020001
100220001
111111111
