111111111
120000001
100000001
100002201
1002p0021
100000001
100000001
100000001
111111111
