111111111
120000201
102002021
100200001
1022p0001
100000001
102000201
100000001
111111111
