111111111
120220221
122220001
100022021
1220p0001
102022221
120002221
120200201
111111111
