111111111
122020201
122002221
120022221
1002p0201
102222201
120202021
122002021
111111111
