111111111
122222021
122222221
122022221
1222p2221
102220221
122222221
122222221
111111111
