111111111
122222221
102020021
102202221
1020p2001
122202221
122222021
122222221
111111111
