111111111
120222221
122222021
122222221
1222p2201
120022021
122222221
122222221
111111111
