111111111
122222221
122222221
122022221
1222p0221
122222221
122022221
102222221
111111111
