111111111
120220201
120200221
102220221
1220p2201
122222221
100222221
122222221
111111111
