111111111
120000001
100000001
102020001
1200p0021
100000001
100220001
100002001
111111111
