111111111
100000001
100002221
100000201
1000p0001
102002021
100000201
100000001
111111111
