111111111
100220021
122002021
100222221
1202p0001
102002021
120202021
102220221
111111111
