111111111
100000221
100000021
120000021
1000p0001
120000001
100200201
100000001
111111111
