111111111
122222201
120002021
122022221
1222p2201
122222221
122202021
122202221
111111111
