111111111
102222221
102002201
122000001
1222p2221
120222001
120222221
102002021
111111111
