111111111
122222201
120222221
122222021
1220p2221
122202221
122202221
102222201
111111111
