111111111
120000201
100200201
100200001
1000p0001
100000201
102000021
100000001
111111111
