111111111
100000001
102000001
122200001
1000p0001
120000021
122002201
100000201
111111111
