111111111
100000221
102220201
100222221
1022p2221
100220201
120220021
100220021
111111111
