111111111
102220201
122020001
102000001
1000p0001
100020021
102000201
120002221
111111111
