111111111
122222221
102222221
122202221
1222p2221
122222221
122022221
120202021
111111111
