111111111
120022021
102020001
122020221
1222p2221
122002221
122222221
102222201
111111111
