111111111
100200001
100020001
100200021
1000p2001
102000201
100220021
100200001
111111111
