111111111
102200021
120002021
102000201
1002p2021
102202201
120220021
120022001
111111111
