111111111
100200001
100220001
102000021
1000p0221
120000001
120000001
102020221
111111111
